10 x 20
*********O**********
*  R        R      *
*   R +  *  *      *
*        H  *      *
*   **     +   *   *
*   *      *  *    *
*     *      R  *  *
*  *     *     **  *
*     R      *     O
*O******************